NO ./path_to_the_north_texture
SO ./path_to_the_south_texture
WE ./path_to_the_west_texture
EA ./path_to_the_east_texture

F 220,100,0
C 225,30,0

        11111111111111111111111111
        11000000000110000000000001
        11001000000000000000000001
1111111111110000011100000000000011
1000000000110000011101111111111111
1100000000011000000000000N00000001
1100000000011000000000000000000001
1100000000011000000000000000000001
1111011111111101110000001000111111
111111111111111111111111111111    